Country/Territory,Region,Edition,Status,PRRating,CLRating,ElectoralProcess,PoliticalPluralismAndParticipation,FunctioningOfGovernment,AddQ,AddA,TotalPoliticalRights,FreedomOfExpressionAndBelief,AssociationalAndOrganizationalRights,RuleOfLaw,PersonalAutonomyAndIndividualRights,TotalCivilLiberties,TotalFreedomScore
Abkhazia,Eurasia,2016,PF,4,5,6,8,5,0,0,19,8,6,4,5,23,42
Afghanistan,Asia,2016,NF,6,6,2,6,2,0,0,10,6,4,2,2,14,24
Albania,Europe,2016,PF,3,3,8,13,6,0,0,27,13,9,9,9,40,67
Algeria,Africa,2016,NF,6,5,4,4,3,0,0,11,7,5,5,7,24,35
Andorra,Europe,2016,F,1,1,12,15,12,0,0,39,16,11,15,15,57,96
Angola,Africa,2016,NF,6,6,3,6,1,0,0,10,5,3,3,3,14,24
Antigua and Barbuda,Americas,2016,F,2,2,12,13,8,0,0,33,14,9,13,13,49,82
Argentina,Americas,2016,F,2,2,11,14,6,0,0,31,14,11,10,13,48,79
Armenia,Eurasia,2016,PF,5,4,5,7,4,0,0,16,9,6,6,9,30,46
Australia,Asia,2016,F,1,1,12,16,12,0,0,40,16,12,15,15,58,98
Austria,Europe,2016,F,1,1,12,15,10,0,0,37,16,12,15,15,58,95
Azerbaijan,Eurasia,2016,NF,7,6,1,3,1,0,0,5,3,1,2,5,11,16
Bahamas,Americas,2016,F,1,1,12,16,10,0,0,38,16,12,13,13,54,92
Bahrain,Middle East,2016,NF,7,6,2,2,3,3,0,4,2,1,1,6,10,14
Bangladesh,Asia,2016,PF,4,4,7,9,5,0,0,21,7,6,6,9,28,49
Barbados,Americas,2016,F,1,1,12,16,12,0,0,40,16,12,15,15,58,98
Belarus,Eurasia,2016,NF,7,6,0,3,1,0,0,4,3,1,2,7,13,17
Belgium,Europe,2016,F,1,1,12,16,12,0,0,40,15,12,14,15,56,96
Belize,Americas,2016,F,1,2,12,14,10,0,0,36,15,11,12,13,51,87
Benin,Africa,2016,F,2,2,9,16,8,0,0,33,15,12,12,10,49,82
Bhutan,Asia,2016,PF,3,4,10,10,10,1,0,29,9,4,6,8,27,56
Bolivia,Americas,2016,PF,3,3,11,11,7,0,0,29,14,9,6,10,39,68
Bosnia and Herzegovina,Europe,2016,PF,4,3,8,10,4,0,0,22,10,7,8,10,35,57
Botswana,Africa,2016,F,3,2,10,10,8,0,0,28,12,10,12,11,45,73
Brazil,Americas,2016,F,2,2,11,14,8,0,0,33,15,10,10,13,48,81
Brunei,Asia,2016,NF,6,5,0,3,3,0,1,7,6,3,6,7,22,29
Bulgaria,Europe,2016,F,2,2,11,14,8,0,0,33,14,11,10,12,47,80
Burkina Faso,Africa,2016,PF,4,3,6,9,6,0,0,21,14,8,8,8,38,59
Burundi,Africa,2016,NF,7,6,1,4,0,0,0,5,6,2,1,5,14,19
Cabo Verde,Africa,2016,F,1,1,12,15,10,0,0,37,15,11,14,13,53,90
Cambodia,Asia,2016,NF,6,5,4,4,3,0,0,11,9,3,3,6,21,32
Cameroon,Africa,2016,NF,6,6,3,3,3,0,0,9,7,3,1,4,15,24
Canada,Americas,2016,F,1,1,12,16,12,0,0,40,16,12,15,16,59,99
Central African Republic,Africa,2016,NF,7,7,1,1,0,1,0,1,4,1,0,1,6,7
Chad,Africa,2016,NF,7,6,2,1,1,0,0,4,7,5,1,3,16,20
Chile,Americas,2016,F,1,1,12,15,11,0,0,38,16,12,14,15,57,95
China,Asia,2016,NF,7,6,0,1,2,2,0,1,4,3,2,6,15,16
Colombia,Americas,2016,PF,3,4,10,11,8,0,0,29,12,5,7,10,34,63
Comoros,Africa,2016,PF,3,4,9,11,4,0,0,24,10,7,8,6,31,55
Congo (Brazzaville),Africa,2016,NF,6,5,1,2,3,0,0,6,7,6,2,7,22,28
Congo (Kinshasa),Africa,2016,NF,6,6,3,4,2,0,0,9,8,3,0,5,16,25
Costa Rica,Americas,2016,F,1,1,12,15,10,0,0,37,16,11,13,13,53,90
Cote d'Ivoire,Africa,2016,PF,4,4,7,8,5,0,0,20,11,7,6,7,31,51
Crimea,Eurasia,2016,NF,7,6,0,0,0,1,0,-1,3,1,0,6,10,9
Croatia,Europe,2016,F,1,2,12,15,10,0,0,37,14,12,11,13,50,87
Cuba,Americas,2016,NF,7,6,0,0,1,0,0,1,5,0,3,6,14,15
Cyprus,Europe,2016,F,1,1,11,16,11,0,0,38,15,12,15,14,56,94
Czech Republic,Europe,2016,F,1,1,12,15,11,0,0,38,16,12,14,15,57,95
Denmark,Europe,2016,F,1,1,12,16,12,0,0,40,16,12,15,15,58,98
Djibouti,Africa,2016,NF,6,5,3,3,3,0,0,9,6,3,4,6,19,28
Dominica,Americas,2016,F,1,1,12,16,10,0,0,38,15,12,15,15,57,95
Dominican Republic,Americas,2016,PF,3,3,10,10,9,0,0,29,14,10,8,9,41,70
Ecuador,Americas,2016,PF,3,3,7,11,6,0,0,24,12,7,6,10,35,59
Egypt,Africa,2016,NF,6,5,3,4,2,0,0,9,5,4,2,7,18,27
El Salvador,Americas,2016,F,2,3,10,14,9,0,0,33,12,8,8,8,36,69
Equatorial Guinea,Africa,2016,NF,7,7,0,1,0,0,0,1,4,0,0,3,7,8
Eritrea,Africa,2016,NF,7,7,0,0,1,0,0,1,0,0,0,2,2,3
Estonia,Europe,2016,F,1,1,12,15,11,0,0,38,16,12,14,14,56,94
Eswatini,Africa,2016,NF,7,5,0,1,0,0,0,1,7,2,4,4,17,18
Ethiopia,Africa,2016,NF,7,6,1,0,3,0,0,4,3,0,3,5,11,15
Fiji,Asia,2016,PF,3,3,9,11,7,0,0,27,11,5,9,10,35,62
Finland,Europe,2016,F,1,1,12,16,12,0,0,40,16,12,16,16,60,100
France,Europe,2016,F,1,1,12,15,11,0,0,38,14,11,13,15,53,91
Gabon,Africa,2016,NF,6,5,2,4,3,0,0,9,10,4,6,5,25,34
Gaza Strip,Middle East,2016,NF,7,6,0,2,1,0,0,3,4,3,0,2,9,12
Georgia,Eurasia,2016,PF,3,3,9,11,7,0,0,27,11,8,8,10,37,64
Germany,Europe,2016,F,1,1,12,15,12,0,0,39,15,12,14,15,56,95
Ghana,Africa,2016,F,1,2,12,15,10,0,0,37,14,11,11,10,46,83
Greece,Europe,2016,F,2,2,12,15,8,0,0,35,14,11,10,13,48,83
Grenada,Americas,2016,F,1,2,12,16,10,0,0,38,15,11,12,13,51,89
Guatemala,Americas,2016,PF,4,4,8,10,5,0,0,23,12,6,5,8,31,54
Guinea,Africa,2016,PF,5,5,6,8,3,0,0,17,9,5,4,5,23,40
Guinea-Bissau,Africa,2016,PF,5,5,7,8,1,0,0,16,10,5,3,5,23,39
Guyana,Americas,2016,F,2,3,11,13,8,0,0,32,15,10,8,9,42,74
Haiti,Americas,2016,PF,5,5,4,8,5,0,0,17,10,4,4,6,24,41
Honduras,Americas,2016,PF,4,4,7,9,3,0,0,19,9,5,4,8,26,45
Hong Kong,Asia,2016,PF,5,2,3,7,6,0,0,16,12,8,14,13,47,63
Hungary,Europe,2016,F,2,2,9,15,8,0,0,32,13,11,10,13,47,79
Iceland,Europe,2016,F,1,1,12,16,12,0,0,40,16,12,16,16,60,100
India,Asia,2016,F,2,3,12,14,9,0,0,35,13,10,9,10,42,77
Indian Kashmir,Asia,2016,PF,4,4,9,9,4,0,0,22,9,6,6,8,29,51
Indonesia,Asia,2016,PF,2,4,11,14,6,0,0,31,12,8,5,9,34,65
Iran,Middle East,2016,NF,6,6,3,2,2,0,0,7,2,1,3,4,10,17
Iraq,Middle East,2016,NF,5,6,8,5,2,3,0,12,5,6,0,4,15,27
Ireland,Europe,2016,F,1,1,12,16,11,0,0,39,16,12,14,15,57,96
Israel,Middle East,2016,F,1,2,12,14,10,0,0,36,12,10,11,11,44,80
Italy,Europe,2016,F,1,1,12,14,10,0,0,36,15,12,12,14,53,89
Jamaica,Americas,2016,F,2,3,12,13,9,0,0,34,15,9,7,10,41,75
Japan,Asia,2016,F,1,1,12,16,12,0,0,40,15,12,15,14,56,96
Jordan,Middle East,2016,NF,6,5,2,6,3,0,0,11,7,4,6,8,25,36
Kazakhstan,Eurasia,2016,NF,6,5,2,3,1,0,0,6,4,2,4,8,18,24
Kenya,Africa,2016,PF,4,4,7,10,5,0,0,22,11,6,5,7,29,51
Kiribati,Asia,2016,F,1,1,12,16,8,0,0,36,15,12,15,13,55,91
Kosovo,Europe,2016,PF,3,4,9,10,5,0,0,24,9,6,6,7,28,52
Kuwait,Middle East,2016,PF,5,5,2,7,4,0,0,13,6,4,7,6,23,36
Kyrgyzstan,Eurasia,2016,PF,5,5,6,6,4,2,0,14,9,4,4,7,24,38
Laos,Asia,2016,NF,7,6,0,0,1,0,0,1,4,0,2,5,11,12
Latvia,Europe,2016,F,2,2,12,14,9,0,0,35,15,12,12,12,51,86
Lebanon,Middle East,2016,PF,5,4,2,9,2,0,0,13,11,7,5,7,30,43
Lesotho,Africa,2016,PF,3,3,10,12,6,0,0,28,14,7,9,9,39,67
Liberia,Africa,2016,PF,3,4,9,12,7,0,0,28,10,8,7,8,33,61
Libya,Africa,2016,NF,6,6,4,2,0,0,0,6,6,3,1,4,14,20
Liechtenstein,Europe,2016,F,1,1,12,15,12,0,0,39,16,12,15,16,59,98
Lithuania,Europe,2016,F,1,1,12,16,10,0,0,38,16,11,13,13,53,91
Luxembourg,Europe,2016,F,1,1,12,16,10,0,0,38,16,12,16,16,60,98
Madagascar,Africa,2016,PF,3,4,9,10,5,0,0,24,10,8,6,8,32,56
Malawi,Africa,2016,PF,3,3,8,12,7,0,0,27,13,8,9,7,37,64
Malaysia,Asia,2016,PF,4,4,6,7,5,0,0,18,7,6,5,9,27,45
Maldives,Asia,2016,PF,4,5,7,6,6,0,0,19,6,5,6,7,24,43
Mali,Africa,2016,PF,5,4,6,7,4,0,0,17,12,6,6,4,28,45
Malta,Europe,2016,F,1,1,12,16,11,0,0,39,16,12,15,14,57,96
Marshall Islands,Asia,2016,F,1,1,12,15,10,0,0,37,16,11,15,13,55,92
Mauritania,Africa,2016,NF,6,5,3,2,4,0,0,9,9,4,4,4,21,30
Mauritius,Africa,2016,F,1,2,12,15,11,0,0,38,15,12,13,12,52,90
Mexico,Americas,2016,PF,3,3,9,12,7,0,0,28,13,8,6,10,37,65
Micronesia,Asia,2016,F,1,1,12,15,10,0,0,37,16,11,15,14,56,93
Moldova,Eurasia,2016,PF,3,3,10,11,4,0,0,25,11,8,7,9,35,60
Monaco,Europe,2016,F,2,1,10,11,10,0,0,31,16,12,15,14,57,88
Mongolia,Asia,2016,F,1,2,11,16,9,0,0,36,15,11,12,12,50,86
Montenegro,Europe,2016,PF,3,3,9,11,7,0,0,27,12,9,10,12,43,70
Morocco,Africa,2016,PF,5,4,5,7,3,0,0,15,8,5,6,7,26,41
Mozambique,Africa,2016,PF,4,4,6,10,6,0,0,22,11,7,7,9,34,56
Myanmar,Asia,2016,NF,6,5,3,8,3,3,0,11,7,4,1,5,17,28
Nagorno-Karabakh,Eurasia,2016,PF,5,5,6,6,3,0,0,15,6,3,4,5,18,33
Namibia,Africa,2016,F,2,2,10,11,9,0,0,30,14,12,11,10,47,77
Nauru,Asia,2016,F,2,2,12,15,8,0,0,35,13,10,12,14,49,84
Nepal,Asia,2016,PF,3,4,9,11,5,0,0,25,9,5,5,7,26,51
Netherlands,Europe,2016,F,1,1,12,16,12,0,0,40,16,12,15,16,59,99
New Zealand,Asia,2016,F,1,1,12,16,12,0,0,40,16,12,15,15,58,98
Nicaragua,Americas,2016,PF,4,3,6,7,6,0,0,19,12,6,7,10,35,54
Niger,Africa,2016,PF,3,4,8,9,7,0,0,24,11,6,5,6,28,52
Nigeria,Africa,2016,PF,4,5,9,10,5,1,0,23,9,7,4,5,25,48
North Korea,Asia,2016,NF,7,7,0,0,0,0,0,0,0,0,0,3,3,3
North Macedonia,Europe,2016,PF,4,3,6,10,6,0,0,22,10,8,7,10,35,57
Northern Cyprus,Europe,2016,F,2,2,11,12,9,0,0,32,14,9,12,12,47,79
Norway,Europe,2016,F,1,1,12,16,12,0,0,40,16,12,16,16,60,100
Oman,Middle East,2016,NF,6,5,2,2,2,0,2,8,5,3,4,5,17,25
Pakistan,Asia,2016,PF,4,5,7,8,5,0,0,20,5,6,4,6,21,41
Pakistani Kashmir,Asia,2016,NF,6,5,4,4,3,2,0,9,6,4,3,6,19,28
Palau,Asia,2016,F,1,1,12,15,10,0,0,37,16,11,15,13,55,92
Panama,Americas,2016,F,2,2,12,15,8,0,0,35,15,11,10,12,48,83
Papua New Guinea,Asia,2016,PF,4,3,9,10,4,0,0,23,12,9,7,8,36,59
Paraguay,Americas,2016,PF,3,3,10,12,5,0,0,27,12,8,7,10,37,64
Peru,Americas,2016,F,2,3,10,13,7,0,0,30,15,8,8,10,41,71
Philippines,Asia,2016,PF,3,3,9,11,7,0,0,27,14,9,5,10,38,65
Poland,Europe,2016,F,1,1,12,16,10,0,0,38,16,12,13,14,55,93
Portugal,Europe,2016,F,1,1,12,16,11,0,0,39,16,12,15,15,58,97
Puerto Rico,Americas,2016,F,1,1,12,15,10,0,0,37,16,11,12,14,53,90
Qatar,Middle East,2016,NF,6,5,2,2,3,0,2,9,8,2,4,4,18,27
Romania,Europe,2016,F,2,2,11,14,9,0,0,34,14,11,12,12,49,83
Russia,Eurasia,2016,NF,6,6,1,3,3,0,0,7,3,3,2,7,15,22
Rwanda,Africa,2016,NF,6,6,2,1,5,0,0,8,4,2,3,7,16,24
Samoa,Asia,2016,F,2,2,9,13,9,0,0,31,14,10,13,12,49,80
San Marino,Europe,2016,F,1,1,12,16,12,0,0,40,16,12,16,16,60,100
Sao Tome and Principe,Africa,2016,F,2,2,11,14,9,0,0,34,15,10,12,10,47,81
Saudi Arabia,Middle East,2016,NF,7,7,0,0,1,0,2,3,3,0,2,2,7,10
Senegal,Africa,2016,F,2,2,11,13,9,0,0,33,15,10,10,10,45,78
Serbia,Europe,2016,F,2,2,10,13,7,0,0,30,14,11,10,13,48,78
Seychelles,Africa,2016,PF,3,3,9,10,7,0,0,26,11,9,11,11,42,68
Sierra Leone,Africa,2016,PF,3,3,10,11,7,0,0,28,12,7,9,9,37,65
Singapore,Asia,2016,PF,4,4,4,8,7,0,0,19,9,4,7,12,32,51
Slovakia,Europe,2016,F,1,1,12,15,9,0,0,36,15,12,12,14,53,89
Slovenia,Europe,2016,F,1,1,12,16,11,0,0,39,14,12,14,13,53,92
Solomon Islands,Asia,2016,PF,3,3,9,10,6,0,0,25,14,9,8,12,43,68
Somalia,Africa,2016,NF,7,7,0,0,0,0,0,0,1,0,0,1,2,2
Somaliland,Africa,2016,PF,5,5,2,9,4,0,0,15,7,5,7,6,25,40
South Africa,Africa,2016,F,2,2,12,13,8,0,0,33,15,12,9,10,46,79
South Korea,Asia,2016,F,2,2,11,13,10,0,0,34,12,11,13,13,49,83
South Ossetia,Eurasia,2016,NF,7,6,2,2,0,2,0,2,4,1,1,3,9,11
South Sudan,Africa,2016,NF,7,6,3,1,1,3,0,2,4,3,1,4,12,14
Spain,Europe,2016,F,1,1,12,16,11,0,0,39,15,11,15,15,56,95
Sri Lanka,Asia,2016,PF,4,4,8,10,6,1,0,23,9,8,7,8,32,55
St. Kitts and Nevis,Americas,2016,F,2,1,10,16,9,0,0,35,15,12,13,13,53,88
St. Lucia,Americas,2016,F,1,1,12,16,11,0,0,39,15,12,12,14,53,92
St. Vincent and the Grenadines,Americas,2016,F,1,1,11,16,10,0,0,37,15,12,13,14,54,91
Sudan,Africa,2016,NF,7,7,2,3,1,4,0,2,2,1,0,1,4,6
Suriname,Americas,2016,F,2,3,12,14,8,0,0,34,15,11,7,10,43,77
Sweden,Europe,2016,F,1,1,12,16,12,0,0,40,16,12,16,16,60,100
Switzerland,Europe,2016,F,1,1,12,15,12,0,0,39,15,12,15,15,57,96
Syria,Middle East,2016,NF,7,7,0,0,0,3,0,-3,2,0,0,0,2,-1
Taiwan,Asia,2016,F,1,2,12,15,10,0,0,37,14,11,14,13,52,89
Tajikistan,Eurasia,2016,NF,7,6,1,0,1,0,0,2,4,3,3,4,14,16
Tanzania,Africa,2016,PF,3,4,8,12,7,0,0,27,9,6,9,9,33,60
Thailand,Asia,2016,NF,6,5,1,3,3,0,0,7,6,4,5,10,25,32
Gambia,Africa,2016,NF,7,6,1,4,0,0,0,5,3,3,1,6,13,18
Tibet,Asia,2016,NF,7,7,0,0,1,3,0,-2,0,0,0,3,3,1
Timor-Leste,Asia,2016,PF,3,3,11,12,6,0,0,29,12,8,7,9,36,65
Togo,Africa,2016,PF,4,4,6,7,5,0,0,18,9,7,7,7,30,48
Tonga,Asia,2016,F,2,2,11,14,6,0,0,31,13,8,11,12,44,75
Transnistria,Eurasia,2016,NF,6,6,3,5,2,0,0,10,5,2,2,5,14,24
Trinidad and Tobago,Americas,2016,F,2,2,11,13,9,0,0,33,15,11,9,13,48,81
Tunisia,Africa,2016,F,1,3,12,16,9,0,0,37,13,9,9,11,42,79
Turkey,Europe,2016,PF,3,4,9,9,6,0,0,24,8,6,6,9,29,53
Turkmenistan,Eurasia,2016,NF,7,7,0,0,0,0,0,0,1,0,0,3,4,4
Tuvalu,Asia,2016,F,1,1,12,15,10,0,0,37,16,12,15,14,57,94
Uganda,Africa,2016,NF,6,5,3,5,3,0,0,11,9,4,5,7,25,36
Ukraine,Eurasia,2016,PF,3,3,9,10,6,0,0,25,11,9,6,10,36,61
United Arab Emirates,Middle East,2016,NF,6,6,1,2,2,0,2,7,4,2,3,4,13,20
United Kingdom,Europe,2016,F,1,1,12,16,12,0,0,40,13,12,15,15,55,95
United States,Americas,2016,F,1,1,11,15,10,0,0,36,15,11,13,15,54,90
Uruguay,Americas,2016,F,1,1,12,16,12,0,0,40,16,12,15,15,58,98
Uzbekistan,Eurasia,2016,NF,7,7,0,0,0,0,0,0,0,0,0,3,3,3
Vanuatu,Asia,2016,F,2,2,9,15,7,0,0,31,15,11,10,11,47,78
Venezuela,Americas,2016,PF,5,5,5,8,2,0,0,15,8,3,1,8,20,35
Vietnam,Asia,2016,NF,7,5,0,1,2,0,0,3,4,1,4,8,17,20
West Bank,Middle East,2016,NF,6,5,2,5,2,3,0,6,9,5,5,5,24,30
Western Sahara,Africa,2016,NF,7,7,0,0,0,3,0,-3,3,0,0,4,7,4
Yemen,Middle East,2016,NF,7,6,2,1,1,0,0,4,5,3,2,3,13,17
Zambia,Africa,2016,PF,3,4,8,11,7,0,0,26,11,7,8,8,34,60
Zimbabwe,Africa,2016,PF,5,5,3,6,3,0,0,12,8,4,3,5,20,32
Abkhazia,Eurasia,2015,PF,4,5,6,8,4,0,0,18,8,6,4,5,23,41
Afghanistan,Asia,2015,NF,6,6,3,6,2,0,0,11,5,4,2,2,13,24
Albania,Europe,2015,PF,3,3,8,13,6,0,0,27,13,9,9,9,40,67
Algeria,Africa,2015,NF,6,5,4,4,3,0,0,11,7,4,5,7,23,34
Andorra,Europe,2015,F,1,1,12,15,12,0,0,39,16,11,15,15,57,96
Angola,Africa,2015,NF,6,5,3,6,1,0,0,10,7,4,4,3,18,28
Antigua and Barbuda,Americas,2015,F,2,2,11,13,7,0,0,31,14,9,13,13,49,80
Argentina,Americas,2015,F,2,2,11,14,6,0,0,31,14,11,11,13,49,80
Armenia,Eurasia,2015,PF,5,4,5,7,4,0,0,16,9,6,6,9,30,46
Australia,Asia,2015,F,1,1,12,15,12,0,0,39,16,12,15,15,58,97
Austria,Europe,2015,F,1,1,12,15,11,0,0,38,16,12,15,15,58,96
Azerbaijan,Eurasia,2015,NF,6,6,1,3,2,0,0,6,4,1,3,6,14,20
Bahamas,Americas,2015,F,1,1,12,16,10,0,0,38,16,12,15,15,58,96
Bahrain,Middle East,2015,NF,7,6,2,2,3,2,0,5,2,1,1,6,10,15
Bangladesh,Asia,2015,PF,4,4,7,9,5,0,0,21,8,6,6,9,29,50
Barbados,Americas,2015,F,1,1,12,16,12,0,0,40,16,12,16,15,59,99
Belarus,Eurasia,2015,NF,7,6,0,3,1,0,0,4,3,1,1,5,10,14
Belgium,Europe,2015,F,1,1,12,16,12,0,0,40,15,12,15,15,57,97
Belize,Americas,2015,F,1,2,12,14,10,0,0,36,15,11,12,13,51,87
Benin,Africa,2015,F,2,2,8,16,8,0,0,32,15,12,12,10,49,81
Bhutan,Asia,2015,PF,3,4,10,10,10,1,0,29,9,4,6,8,27,56
Bolivia,Americas,2015,PF,3,3,11,11,7,0,0,29,14,9,6,10,39,68
Bosnia and Herzegovina,Europe,2015,PF,4,3,8,10,5,0,0,23,10,7,10,10,37,60
Botswana,Africa,2015,F,3,2,10,10,8,0,0,28,12,10,12,11,45,73
Brazil,Americas,2015,F,2,2,11,14,8,0,0,33,15,10,10,13,48,81
Brunei,Asia,2015,NF,6,5,0,3,3,0,1,7,6,3,6,8,23,30
Bulgaria,Europe,2015,F,2,2,11,14,8,0,0,33,14,11,10,11,46,79
Burkina Faso,Africa,2015,PF,6,3,2,6,1,0,0,9,13,8,7,8,36,45
Burundi,Africa,2015,NF,6,5,4,5,2,0,0,11,8,3,4,6,21,32
Cabo Verde,Africa,2015,F,1,1,12,15,10,0,0,37,15,11,14,13,53,90
Cambodia,Asia,2015,NF,6,5,4,4,3,0,0,11,9,3,2,6,20,31
Cameroon,Africa,2015,NF,6,6,3,3,3,0,0,9,7,3,2,4,16,25
Canada,Americas,2015,F,1,1,12,16,11,0,0,39,16,12,15,16,59,98
Central African Republic,Africa,2015,NF,7,7,0,1,0,1,0,0,4,1,0,1,6,6
Chad,Africa,2015,NF,7,6,3,1,1,0,0,5,7,4,2,3,16,21
Chile,Americas,2015,F,1,1,12,15,12,0,0,39,16,11,14,15,56,95
China,Asia,2015,NF,7,6,0,1,2,1,0,2,4,3,2,6,15,17
Colombia,Americas,2015,PF,3,4,10,11,8,0,0,29,12,5,7,10,34,63
Comoros,Africa,2015,PF,3,4,9,11,5,0,0,25,10,6,8,6,30,55
Congo (Brazzaville),Africa,2015,NF,6,5,1,3,3,0,0,7,8,6,2,7,23,30
Congo (Kinshasa),Africa,2015,NF,6,6,3,4,2,0,0,9,8,3,0,5,16,25
Costa Rica,Americas,2015,F,1,1,12,15,10,0,0,37,16,11,13,13,53,90
Cote d'Ivoire,Africa,2015,PF,5,4,6,7,4,0,0,17,10,7,6,6,29,46
Crimea,Eurasia,2015,NF,7,6,0,0,0,1,0,-1,3,1,0,7,11,10
Croatia,Europe,2015,F,1,2,12,15,9,0,0,36,14,12,11,13,50,86
Cuba,Americas,2015,NF,7,6,0,0,1,0,0,1,4,0,3,6,13,14
Cyprus,Europe,2015,F,1,1,11,16,10,0,0,37,15,12,15,14,56,93
Czech Republic,Europe,2015,F,1,1,12,15,11,0,0,38,16,12,14,15,57,95
Denmark,Europe,2015,F,1,1,12,16,12,0,0,40,16,12,15,15,58,98
Djibouti,Africa,2015,NF,6,5,3,3,3,0,0,9,6,3,4,6,19,28
Dominica,Americas,2015,F,1,1,12,16,10,0,0,38,15,12,15,15,57,95
Dominican Republic,Americas,2015,F,2,3,10,11,9,0,0,30,15,10,8,10,43,73
Ecuador,Americas,2015,PF,3,3,7,11,6,0,0,24,12,7,6,10,35,59
Egypt,Africa,2015,NF,6,5,2,4,2,0,0,8,5,4,2,7,18,26
El Salvador,Americas,2015,F,2,3,12,14,9,0,0,35,15,8,8,9,40,75
Equatorial Guinea,Africa,2015,NF,7,7,0,1,0,0,0,1,4,0,0,3,7,8
Eritrea,Africa,2015,NF,7,7,0,0,1,0,0,1,0,0,0,2,2,3
Estonia,Europe,2015,F,1,1,12,15,12,0,0,39,16,12,14,14,56,95
Eswatini,Africa,2015,NF,7,5,0,1,0,0,0,1,6,2,5,4,17,18
Ethiopia,Africa,2015,NF,6,6,1,2,4,0,0,7,3,0,3,5,11,18
Fiji,Asia,2015,PF,3,4,9,11,6,0,0,26,11,4,9,10,34,60
Finland,Europe,2015,F,1,1,12,16,12,0,0,40,16,12,16,16,60,100
France,Europe,2015,F,1,1,12,15,11,0,0,38,15,12,15,15,57,95
Gabon,Africa,2015,NF,6,5,2,4,3,0,0,9,10,4,6,5,25,34
Gaza Strip,Middle East,2015,NF,7,6,2,2,1,0,0,5,5,3,0,2,10,15
Georgia,Eurasia,2015,PF,3,3,9,10,7,0,0,26,12,8,8,10,38,64
Germany,Europe,2015,F,1,1,12,15,12,0,0,39,15,12,15,15,57,96
Ghana,Africa,2015,F,1,2,12,15,10,0,0,37,14,11,12,10,47,84
Greece,Europe,2015,F,2,2,12,15,8,0,0,35,14,11,10,13,48,83
Grenada,Americas,2015,F,1,2,12,16,10,0,0,38,15,11,12,13,51,89
Guatemala,Americas,2015,PF,3,4,9,10,5,0,0,24,12,6,5,8,31,55
Guinea,Africa,2015,PF,5,5,6,8,3,0,0,17,9,6,4,5,24,41
Guinea-Bissau,Africa,2015,PF,5,5,8,8,1,0,0,17,10,5,3,5,23,40
Guyana,Americas,2015,F,2,3,11,13,6,0,0,30,15,10,7,9,41,71
Haiti,Americas,2015,PF,5,5,4,8,5,0,0,17,10,4,4,6,24,41
Honduras,Americas,2015,PF,4,4,7,9,4,0,0,20,10,6,5,8,29,49
Hong Kong,Asia,2015,PF,5,2,3,7,6,0,0,16,13,8,15,13,49,65
Hungary,Europe,2015,F,2,2,9,15,8,0,0,32,14,11,11,14,50,82
Iceland,Europe,2015,F,1,1,12,16,11,0,0,39,16,12,16,16,60,99
India,Asia,2015,F,2,3,12,14,9,0,0,35,13,11,9,10,43,78
Indian Kashmir,Asia,2015,PF,4,4,9,9,4,0,0,22,9,6,6,8,29,51
Indonesia,Asia,2015,PF,2,4,10,14,6,0,0,30,12,8,5,9,34,64
Iran,Middle East,2015,NF,6,6,3,2,2,0,0,7,2,1,3,4,10,17
Iraq,Middle East,2015,NF,6,6,8,5,1,3,0,11,5,4,0,4,13,24
Ireland,Europe,2015,F,1,1,12,16,11,0,0,39,16,12,15,15,58,97
Israel,Middle East,2015,F,1,2,12,14,10,0,0,36,12,10,11,11,44,80
Italy,Europe,2015,F,1,1,12,14,10,0,0,36,15,12,12,14,53,89
Jamaica,Americas,2015,F,2,3,12,13,9,0,0,34,15,9,6,10,40,74
Japan,Asia,2015,F,1,1,12,15,12,0,0,39,15,11,15,14,55,94
Jordan,Middle East,2015,NF,6,5,2,6,3,0,0,11,7,4,6,8,25,36
Kazakhstan,Eurasia,2015,NF,6,5,2,3,1,0,0,6,4,2,4,8,18,24
Kenya,Africa,2015,PF,4,4,7,10,5,0,0,22,11,6,5,7,29,51
Kiribati,Asia,2015,F,1,1,12,16,8,0,0,36,15,12,15,13,55,91
Kosovo,Europe,2015,PF,4,4,9,10,4,0,0,23,9,6,6,8,29,52
Kuwait,Middle East,2015,PF,5,5,2,7,5,0,0,14,6,4,7,6,23,37
Kyrgyzstan,Eurasia,2015,PF,5,5,6,6,4,2,0,14,9,4,4,7,24,38
Laos,Asia,2015,NF,7,6,0,0,1,0,0,1,4,0,2,5,11,12
Latvia,Europe,2015,F,2,2,12,14,8,0,0,34,15,12,12,12,51,85
Lebanon,Middle East,2015,PF,5,4,2,9,3,0,0,14,11,7,5,7,30,44
Lesotho,Africa,2015,F,2,3,10,12,8,0,0,30,14,7,11,9,41,71
Liberia,Africa,2015,PF,3,4,9,11,6,0,0,26,10,7,6,7,30,56
Libya,Africa,2015,NF,6,6,5,3,0,0,0,8,6,3,1,5,15,23
Liechtenstein,Europe,2015,F,1,1,12,15,12,0,0,39,16,12,15,16,59,98
Lithuania,Europe,2015,F,1,1,12,16,10,0,0,38,16,11,13,13,53,91
Luxembourg,Europe,2015,F,1,1,12,16,10,0,0,38,16,12,16,16,60,98
Madagascar,Africa,2015,PF,4,4,9,9,4,0,0,22,9,8,6,7,30,52
Malawi,Africa,2015,PF,3,4,8,12,7,0,0,27,11,7,9,7,34,61
Malaysia,Asia,2015,PF,4,4,6,7,6,0,0,19,7,6,5,9,27,46
Maldives,Asia,2015,PF,4,4,7,7,6,0,0,20,6,7,7,8,28,48
Mali,Africa,2015,PF,5,4,6,7,4,0,0,17,11,6,6,4,27,44
Malta,Europe,2015,F,1,1,12,16,11,0,0,39,16,12,15,15,58,97
Marshall Islands,Asia,2015,F,1,1,11,15,10,0,0,36,16,11,15,13,55,91
Mauritania,Africa,2015,NF,6,5,3,2,4,0,0,9,10,4,4,4,22,31
Mauritius,Africa,2015,F,1,2,12,15,11,0,0,38,15,12,13,12,52,90
Mexico,Americas,2015,PF,3,3,9,12,7,0,0,28,12,8,6,10,36,64
Micronesia,Asia,2015,F,1,1,12,15,10,0,0,37,16,11,15,14,56,93
Moldova,Eurasia,2015,PF,3,3,10,12,6,0,0,28,11,8,7,9,35,63
Monaco,Europe,2015,F,2,1,10,11,10,0,0,31,16,12,15,14,57,88
Mongolia,Asia,2015,F,1,2,11,16,9,0,0,36,15,11,12,12,50,86
Montenegro,Europe,2015,F,3,2,9,11,7,0,0,27,12,10,10,12,44,71
Morocco,Africa,2015,PF,5,4,5,7,3,0,0,15,8,6,6,7,27,42
Mozambique,Africa,2015,PF,4,3,6,10,7,0,0,23,12,7,7,9,35,58
Myanmar,Asia,2015,NF,6,6,3,6,3,3,0,9,6,4,1,5,16,25
Nagorno-Karabakh,Eurasia,2015,PF,5,5,4,5,3,0,0,12,6,3,4,5,18,30
Namibia,Africa,2015,F,2,2,10,11,9,0,0,30,14,12,11,9,46,76
Nauru,Asia,2015,F,1,2,12,16,9,0,0,37,14,11,12,14,51,88
Nepal,Asia,2015,PF,3,4,8,11,5,0,0,24,9,6,5,7,27,51
Netherlands,Europe,2015,F,1,1,12,16,12,0,0,40,16,12,15,16,59,99
New Zealand,Asia,2015,F,1,1,12,15,12,0,0,39,16,12,15,15,58,97
Nicaragua,Americas,2015,PF,4,3,6,7,6,0,0,19,12,6,7,10,35,54
Niger,Africa,2015,PF,3,4,9,10,7,0,0,26,11,8,5,6,30,56
Nigeria,Africa,2015,PF,4,5,6,9,4,1,0,18,9,7,4,5,25,43
North Korea,Asia,2015,NF,7,7,0,0,0,0,0,0,0,0,0,3,3,3
North Macedonia,Europe,2015,PF,4,3,7,10,6,0,0,23,11,8,8,10,37,60
Northern Cyprus,Europe,2015,F,2,2,11,12,9,0,0,32,14,9,12,12,47,79
Norway,Europe,2015,F,1,1,12,16,12,0,0,40,16,12,16,16,60,100
Oman,Middle East,2015,NF,6,5,2,2,2,0,3,9,5,3,4,5,17,26
Pakistan,Asia,2015,PF,4,5,7,8,5,0,0,20,5,7,4,6,22,42
Pakistani Kashmir,Asia,2015,NF,6,5,4,4,3,2,0,9,6,4,4,6,20,29
Palau,Asia,2015,F,1,1,12,15,10,0,0,37,16,11,15,13,55,92
Panama,Americas,2015,F,2,2,12,15,8,0,0,35,15,11,9,12,47,82
Papua New Guinea,Asia,2015,PF,4,3,9,10,4,0,0,23,12,9,7,8,36,59
Paraguay,Americas,2015,PF,3,3,10,12,5,0,0,27,12,8,7,11,38,65
Peru,Americas,2015,F,2,3,10,13,7,0,0,30,15,8,8,10,41,71
Philippines,Asia,2015,PF,3,3,9,10,7,0,0,26,14,8,5,10,37,63
Poland,Europe,2015,F,1,1,12,16,10,0,0,38,16,12,13,14,55,93
Portugal,Europe,2015,F,1,1,12,16,11,0,0,39,16,12,15,15,58,97
Puerto Rico,Americas,2015,F,1,2,12,15,10,0,0,37,16,10,12,14,52,89
Qatar,Middle East,2015,NF,6,5,2,2,3,0,3,10,8,2,4,4,18,28
Romania,Europe,2015,F,2,2,11,14,9,0,0,34,14,11,12,12,49,83
Russia,Eurasia,2015,NF,6,6,1,3,3,0,0,7,4,4,2,6,16,23
Rwanda,Africa,2015,NF,6,6,2,2,5,0,0,9,4,2,3,7,16,25
Samoa,Asia,2015,F,2,2,9,13,10,0,0,32,14,10,13,12,49,81
San Marino,Europe,2015,F,1,1,12,16,12,0,0,40,16,12,16,16,60,100
Sao Tome and Principe,Africa,2015,F,2,2,11,14,9,0,0,34,15,10,12,10,47,81
Saudi Arabia,Middle East,2015,NF,7,7,0,0,1,0,2,3,3,0,2,2,7,10
Senegal,Africa,2015,F,2,2,11,13,9,0,0,33,15,10,10,10,45,78
Serbia,Europe,2015,F,2,2,10,14,7,0,0,31,15,11,10,13,49,80
Seychelles,Africa,2015,PF,3,3,8,10,7,0,0,25,11,9,11,11,42,67
Sierra Leone,Africa,2015,PF,3,3,10,11,7,0,0,28,12,7,9,9,37,65
Singapore,Asia,2015,PF,4,4,4,8,7,0,0,19,9,4,7,12,32,51
Slovakia,Europe,2015,F,1,1,12,15,10,0,0,37,15,12,12,14,53,90
Slovenia,Europe,2015,F,1,1,12,15,11,0,0,38,14,12,14,13,53,91
Solomon Islands,Asia,2015,PF,3,3,9,10,6,0,0,25,14,9,8,12,43,68
Somalia,Africa,2015,NF,7,7,0,0,0,0,0,0,1,0,0,1,2,2
Somaliland,Africa,2015,PF,4,5,5,10,6,0,0,21,7,5,7,6,25,46
South Africa,Africa,2015,F,2,2,12,13,8,0,0,33,15,12,10,11,48,81
South Korea,Asia,2015,F,2,2,11,13,10,0,0,34,13,11,13,13,50,84
South Ossetia,Eurasia,2015,NF,7,6,2,2,0,3,0,1,4,1,1,3,9,10
South Sudan,Africa,2015,NF,7,6,3,0,1,2,0,2,4,3,1,5,13,15
Spain,Europe,2015,F,1,1,12,16,11,0,0,39,15,12,15,15,57,96
Sri Lanka,Asia,2015,PF,5,5,6,7,4,1,0,16,6,6,5,8,25,41
St. Kitts and Nevis,Americas,2015,F,1,1,12,16,9,0,0,37,15,12,13,13,53,90
St. Lucia,Americas,2015,F,1,1,12,16,11,0,0,39,15,12,12,14,53,92
St. Vincent and the Grenadines,Americas,2015,F,1,1,11,16,9,0,0,36,15,12,13,14,54,90
Sudan,Africa,2015,NF,7,7,2,3,1,4,0,2,2,1,0,1,4,6
Suriname,Americas,2015,F,2,2,12,13,8,0,0,33,15,11,8,10,44,77
Sweden,Europe,2015,F,1,1,12,16,12,0,0,40,15,12,16,16,59,99
Switzerland,Europe,2015,F,1,1,12,15,12,0,0,39,15,12,15,15,57,96
Syria,Middle East,2015,NF,7,7,0,0,0,3,0,-3,2,0,0,0,2,-1
Taiwan,Asia,2015,F,1,2,12,15,10,0,0,37,14,10,14,13,51,88
Tajikistan,Eurasia,2015,NF,6,6,2,3,2,0,0,7,5,3,3,4,15,22
Tanzania,Africa,2015,PF,3,3,9,12,7,0,0,28,10,7,9,9,35,63
Thailand,Asia,2015,NF,6,5,1,4,3,0,0,8,6,4,5,10,25,33
Gambia,Africa,2015,NF,6,6,2,5,0,0,0,7,3,3,1,6,13,20
Tibet,Asia,2015,NF,7,7,0,0,1,3,0,-2,0,0,0,3,3,1
Timor-Leste,Asia,2015,PF,3,3,11,12,6,0,0,29,12,8,7,9,36,65
Togo,Africa,2015,PF,4,4,5,8,5,0,0,18,9,6,7,7,29,47
Tonga,Asia,2015,F,2,2,11,14,6,0,0,31,13,8,11,12,44,75
Transnistria,Eurasia,2015,NF,6,6,3,5,2,0,0,10,5,2,2,5,14,24
Trinidad and Tobago,Americas,2015,F,2,2,11,13,9,0,0,33,15,11,9,13,48,81
Tunisia,Africa,2015,F,1,3,12,16,8,0,0,36,13,10,9,11,43,79
Turkey,Europe,2015,PF,3,4,10,10,6,0,0,26,8,5,7,9,29,55
Turkmenistan,Eurasia,2015,NF,7,7,0,1,0,0,0,1,2,0,0,3,5,6
Tuvalu,Asia,2015,F,1,1,12,15,10,0,0,37,16,12,15,14,57,94
Uganda,Africa,2015,NF,6,5,3,5,3,0,0,11,9,4,5,7,25,36
Ukraine,Eurasia,2015,PF,3,3,9,10,6,0,0,25,11,9,6,11,37,62
United Arab Emirates,Middle East,2015,NF,6,6,1,2,2,0,3,8,4,2,3,4,13,21
United Kingdom,Europe,2015,F,1,1,12,16,12,0,0,40,15,12,15,15,57,97
United States,Americas,2015,F,1,1,11,16,10,0,0,37,15,11,14,15,55,92
Uruguay,Americas,2015,F,1,1,12,16,12,0,0,40,16,12,15,15,58,98
Uzbekistan,Eurasia,2015,NF,7,7,0,0,0,0,0,0,1,0,0,3,4,4
Vanuatu,Asia,2015,F,2,2,9,15,8,0,0,32,15,11,10,11,47,79
Venezuela,Americas,2015,PF,5,5,5,6,2,0,0,13,8,3,3,8,22,35
Vietnam,Asia,2015,NF,7,5,0,1,2,0,0,3,4,1,4,8,17,20
West Bank,Middle East,2015,NF,6,5,2,5,2,3,0,6,9,6,5,5,25,31
Western Sahara,Africa,2015,NF,7,7,0,0,0,2,0,-2,3,0,0,4,7,5
Yemen,Middle East,2015,NF,6,6,3,4,2,0,0,9,6,3,2,5,16,25
Zambia,Africa,2015,PF,3,4,8,12,6,0,0,26,11,7,8,8,34,60
Zimbabwe,Africa,2015,NF,5,6,3,6,3,0,0,12,6,3,2,5,16,28
Abkhazia,Eurasia,2014,PF,4,5,7,7,4,0,0,18,8,5,4,5,22,40
Afghanistan,Asia,2014,NF,6,6,3,6,2,0,0,11,6,4,2,3,15,26
Albania,Europe,2014,PF,3,3,8,13,6,0,0,27,13,9,9,9,40,67
Algeria,Africa,2014,NF,6,5,4,4,3,0,0,11,6,5,5,7,23,34
Andorra,Europe,2014,F,1,1,12,15,12,0,0,39,16,11,15,15,57,96
Angola,Africa,2014,NF,6,5,4,6,1,0,0,11,7,4,4,3,18,29
Antigua and Barbuda,Americas,2014,F,2,2,11,13,7,0,0,31,14,9,13,13,49,80
Argentina,Americas,2014,F,2,2,11,14,6,0,0,31,14,11,11,13,49,80
Armenia,Eurasia,2014,PF,5,4,5,6,3,0,0,14,8,6,6,9,29,43
Australia,Asia,2014,F,1,1,12,15,12,0,0,39,16,12,15,15,58,97
Austria,Europe,2014,F,1,1,12,15,11,0,0,38,16,12,15,15,58,96
Azerbaijan,Eurasia,2014,NF,6,6,1,3,2,0,0,6,4,2,4,6,16,22
Bahamas,Americas,2014,F,1,1,12,16,10,0,0,38,16,12,15,15,58,96
Bahrain,Middle East,2014,NF,6,6,3,2,3,2,0,6,2,1,1,6,10,16
Bangladesh,Asia,2014,PF,3,4,9,10,5,0,0,24,8,6,6,9,29,53
Barbados,Americas,2014,F,1,1,12,16,12,0,0,40,16,12,16,15,59,99
Belarus,Eurasia,2014,NF,7,6,0,3,1,0,0,4,3,1,1,5,10,14
Belgium,Europe,2014,F,1,1,12,16,12,0,0,40,15,12,15,15,57,97
Belize,Americas,2014,F,1,2,12,14,10,0,0,36,15,11,12,13,51,87
Benin,Africa,2014,F,2,2,8,16,8,0,0,32,15,11,12,10,48,80
Bhutan,Asia,2014,PF,3,4,10,10,9,1,0,28,9,4,6,8,27,55
Bolivia,Americas,2014,PF,3,3,11,11,7,0,0,29,14,9,6,9,38,67
Bosnia and Herzegovina,Europe,2014,PF,3,3,8,10,6,0,0,24,10,7,10,10,37,61
Botswana,Africa,2014,F,3,2,10,10,8,0,0,28,13,10,12,11,46,74
Brazil,Americas,2014,F,2,2,11,14,8,0,0,33,15,10,10,13,48,81
Brunei,Asia,2014,NF,6,5,0,3,3,0,1,7,6,3,6,8,23,30
Bulgaria,Europe,2014,F,2,2,10,14,7,0,0,31,14,11,11,11,47,78
Burkina Faso,Africa,2014,PF,5,3,5,8,4,0,0,17,13,8,7,8,36,53
Burundi,Africa,2014,PF,5,5,4,6,2,0,0,12,8,4,4,6,22,34
Cabo Verde,Africa,2014,F,1,1,12,15,10,0,0,37,15,11,14,13,53,90
Cambodia,Asia,2014,NF,6,5,3,4,3,0,0,10,9,3,2,6,20,30
Cameroon,Africa,2014,NF,6,6,3,3,2,0,0,8,7,3,2,4,16,24
Canada,Americas,2014,F,1,1,12,16,11,0,0,39,16,12,15,16,59,98
Central African Republic,Africa,2014,NF,7,7,0,1,0,1,0,0,4,1,0,1,6,6
Chad,Africa,2014,NF,7,6,3,1,1,0,0,5,7,4,2,3,16,21
Chile,Americas,2014,F,1,1,12,15,12,0,0,39,16,11,14,15,56,95
China,Asia,2014,NF,7,6,0,1,2,1,0,2,4,3,2,6,15,17
Colombia,Americas,2014,PF,3,4,10,11,7,0,0,28,12,5,7,10,34,62
Comoros,Africa,2014,PF,3,4,9,11,5,0,0,25,10,6,8,6,30,55
Congo (Brazzaville),Africa,2014,NF,6,5,1,3,3,0,0,7,8,6,2,7,23,30
Congo (Kinshasa),Africa,2014,NF,6,6,3,4,2,0,0,9,7,3,0,1,11,20
Costa Rica,Americas,2014,F,1,1,12,15,10,0,0,37,16,11,13,13,53,90
Cote d'Ivoire,Africa,2014,PF,5,4,6,7,4,0,0,17,10,7,5,6,28,45
Croatia,Europe,2014,F,1,2,12,15,9,0,0,36,14,12,11,13,50,86
Cuba,Americas,2014,NF,7,6,0,0,1,0,0,1,3,0,2,6,11,12
Cyprus,Europe,2014,F,1,1,11,16,10,0,0,37,15,11,15,14,55,92
Czech Republic,Europe,2014,F,1,1,12,15,10,0,0,37,16,12,14,15,57,94
Denmark,Europe,2014,F,1,1,12,16,12,0,0,40,16,12,15,15,58,98
Djibouti,Africa,2014,NF,6,5,3,3,3,0,0,9,7,3,4,6,20,29
Dominica,Americas,2014,F,1,1,12,16,10,0,0,38,15,12,15,15,57,95
Dominican Republic,Americas,2014,F,2,3,10,11,9,0,0,30,15,10,8,10,43,73
Ecuador,Americas,2014,PF,3,3,7,11,6,0,0,24,13,7,6,10,36,60
Egypt,Africa,2014,NF,6,5,1,6,2,0,0,9,6,4,4,8,22,31
El Salvador,Americas,2014,F,2,3,12,14,9,0,0,35,15,8,9,10,42,77
Equatorial Guinea,Africa,2014,NF,7,7,0,1,0,0,0,1,4,0,0,3,7,8
Eritrea,Africa,2014,NF,7,7,0,0,1,0,0,1,0,0,0,2,2,3
Estonia,Europe,2014,F,1,1,12,15,12,0,0,39,16,12,14,14,56,95
Eswatini,Africa,2014,NF,7,5,0,1,0,0,0,1,8,2,5,4,19,20
Ethiopia,Africa,2014,NF,6,6,1,2,4,0,0,7,3,0,3,5,11,18
Fiji,Asia,2014,PF,6,4,0,5,2,0,0,7,11,3,6,10,30,37
Finland,Europe,2014,F,1,1,12,16,12,0,0,40,16,12,16,16,60,100
France,Europe,2014,F,1,1,12,15,11,0,0,38,15,12,15,15,57,95
Gabon,Africa,2014,NF,6,5,2,4,3,0,0,9,10,4,6,5,25,34
Gaza Strip,Middle East,2014,NF,7,6,2,2,1,0,0,5,4,3,0,3,10,15
Georgia,Eurasia,2014,PF,3,3,8,10,7,0,0,25,12,8,8,10,38,63
Germany,Europe,2014,F,1,1,12,15,12,0,0,39,15,12,15,15,57,96
Ghana,Africa,2014,F,1,2,12,15,10,0,0,37,14,11,12,10,47,84
Greece,Europe,2014,F,2,2,12,15,8,0,0,35,14,11,10,13,48,83
Grenada,Americas,2014,F,1,2,12,16,10,0,0,38,15,11,12,13,51,89
Guatemala,Americas,2014,PF,3,4,9,10,5,0,0,24,12,6,6,8,32,56
Guinea,Africa,2014,PF,5,5,6,8,3,0,0,17,9,6,4,5,24,41
Guinea-Bissau,Africa,2014,NF,6,5,3,5,1,0,0,9,10,5,3,5,23,32
Guyana,Americas,2014,F,2,3,11,13,7,0,0,31,15,10,7,9,41,72
Haiti,Americas,2014,PF,4,5,4,9,5,0,0,18,10,5,4,6,25,43
Honduras,Americas,2014,PF,4,4,7,9,4,0,0,20,11,6,5,9,31,51
Hong Kong,Asia,2014,PF,5,2,3,7,6,0,0,16,14,9,15,13,51,67
Hungary,Europe,2014,F,1,2,12,15,9,0,0,36,15,12,11,14,52,88
Iceland,Europe,2014,F,1,1,12,16,12,0,0,40,16,12,16,16,60,100
India,Asia,2014,F,2,3,11,14,9,0,0,34,13,11,9,10,43,77
Indian Kashmir,Asia,2014,PF,4,4,8,8,4,0,0,20,9,6,6,8,29,49
Indonesia,Asia,2014,PF,2,4,11,13,6,0,0,30,12,8,5,9,34,64
Iran,Middle East,2014,NF,6,6,3,2,2,0,0,7,2,1,3,4,10,17
Iraq,Middle East,2014,NF,5,6,7,5,1,1,0,12,5,4,0,4,13,25
Ireland,Europe,2014,F,1,1,12,16,11,0,0,39,16,12,15,15,58,97
Israel,Middle East,2014,F,1,2,12,14,10,0,0,36,12,11,11,11,45,81
Italy,Europe,2014,F,1,1,12,15,10,0,0,37,15,12,12,14,53,90
Jamaica,Americas,2014,F,2,3,12,13,9,0,0,34,15,9,6,10,40,74
Japan,Asia,2014,F,1,1,12,15,10,0,0,37,14,11,15,13,53,90
Jordan,Middle East,2014,NF,6,5,2,6,3,0,0,11,7,3,6,8,24,35
Kazakhstan,Eurasia,2014,NF,6,5,2,3,1,0,0,6,4,3,4,8,19,25
Kenya,Africa,2014,PF,4,4,7,10,5,0,0,22,11,7,6,7,31,53
Kiribati,Asia,2014,F,1,1,12,16,8,0,0,36,15,12,15,13,55,91
Kosovo,Europe,2014,PF,5,4,6,9,3,1,0,17,8,6,5,7,26,43
Kuwait,Middle East,2014,PF,5,5,2,9,5,0,0,16,6,4,7,6,23,39
Kyrgyzstan,Eurasia,2014,PF,5,5,6,6,4,2,0,14,9,5,4,7,25,39
Laos,Asia,2014,NF,7,6,0,0,1,0,0,1,4,0,2,5,11,12
Latvia,Europe,2014,F,2,2,12,14,7,0,0,33,15,12,12,12,51,84
Lebanon,Middle East,2014,PF,5,4,4,9,3,0,0,16,11,7,5,9,32,48
Lesotho,Africa,2014,F,2,3,10,13,8,0,0,31,14,7,11,9,41,72
Liberia,Africa,2014,PF,3,4,9,11,6,0,0,26,10,8,7,8,33,59
Libya,Africa,2014,PF,4,5,9,9,3,0,0,21,8,5,1,6,20,41
Liechtenstein,Europe,2014,F,1,1,12,15,12,0,0,39,16,12,15,16,59,98
Lithuania,Europe,2014,F,1,1,12,16,9,0,0,37,16,11,13,13,53,90
Luxembourg,Europe,2014,F,1,1,12,16,11,0,0,39,16,12,16,16,60,99
Madagascar,Africa,2014,PF,5,4,6,8,1,0,0,15,9,7,5,7,28,43
Malawi,Africa,2014,PF,3,4,8,11,7,0,0,26,11,7,9,7,34,60
Malaysia,Asia,2014,PF,4,4,6,7,6,0,0,19,8,6,5,9,28,47
Maldives,Asia,2014,PF,4,4,7,7,5,0,0,19,7,7,7,8,29,48
Mali,Africa,2014,PF,5,4,6,7,4,0,0,17,11,6,6,4,27,44
Malta,Europe,2014,F,1,1,12,16,11,0,0,39,16,12,15,15,58,97
Marshall Islands,Asia,2014,F,1,1,11,15,10,0,0,36,16,11,15,13,55,91
Mauritania,Africa,2014,NF,6,5,3,3,5,0,0,11,10,4,4,5,23,34
Mauritius,Africa,2014,F,1,2,12,15,11,0,0,38,15,12,13,12,52,90
Mexico,Americas,2014,PF,3,3,9,12,7,0,0,28,13,8,6,10,37,65
Micronesia,Asia,2014,F,1,1,12,15,10,0,0,37,16,11,15,14,56,93
Moldova,Eurasia,2014,PF,3,3,11,12,6,0,0,29,11,8,7,9,35,64
Monaco,Europe,2014,F,2,1,10,11,10,0,0,31,16,12,15,14,57,88
Mongolia,Asia,2014,F,1,2,11,16,9,0,0,36,15,11,12,12,50,86
Montenegro,Europe,2014,F,3,2,9,11,7,0,0,27,13,10,10,12,45,72
Morocco,Africa,2014,PF,5,4,5,7,3,0,0,15,8,6,6,7,27,42
Mozambique,Africa,2014,PF,4,3,6,10,7,0,0,23,12,7,7,9,35,58
Myanmar,Asia,2014,NF,6,5,3,6,3,3,0,9,7,4,1,5,17,26
Nagorno-Karabakh,Eurasia,2014,PF,5,5,4,5,3,0,0,12,6,3,5,5,19,31
Namibia,Africa,2014,F,2,2,10,11,9,0,0,30,14,12,11,9,46,76
Nauru,Asia,2014,F,1,1,12,16,10,0,0,38,15,11,14,14,54,92
Nepal,Asia,2014,PF,4,4,8,11,4,0,0,23,9,6,5,7,27,50
Netherlands,Europe,2014,F,1,1,12,16,12,0,0,40,16,12,15,16,59,99
New Zealand,Asia,2014,F,1,1,12,15,12,0,0,39,16,12,15,15,58,97
Nicaragua,Americas,2014,PF,4,3,6,7,6,0,0,19,12,6,7,10,35,54
Niger,Africa,2014,PF,3,4,9,10,7,0,0,26,11,8,5,6,30,56
Nigeria,Africa,2014,PF,4,4,6,9,5,0,0,20,9,7,4,6,26,46
North Korea,Asia,2014,NF,7,7,0,0,0,0,0,0,0,0,0,3,3,3
North Macedonia,Europe,2014,PF,3,3,8,11,7,0,0,26,11,8,8,11,38,64
Northern Cyprus,Europe,2014,F,2,2,11,12,9,0,0,32,14,9,12,12,47,79
Norway,Europe,2014,F,1,1,12,16,12,0,0,40,16,12,16,16,60,100
Oman,Middle East,2014,NF,6,5,2,2,2,0,3,9,5,3,4,5,17,26
Pakistan,Asia,2014,PF,4,5,7,9,5,0,0,21,5,6,4,6,21,42
Pakistani Kashmir,Asia,2014,NF,6,5,3,4,3,2,0,8,6,5,4,6,21,29
Palau,Asia,2014,F,1,1,12,15,10,0,0,37,16,11,15,13,55,92
Panama,Americas,2014,F,2,2,12,15,8,0,0,35,15,11,9,12,47,82
Papua New Guinea,Asia,2014,PF,3,3,9,10,5,0,0,24,12,9,7,8,36,60
Paraguay,Americas,2014,PF,3,3,10,12,4,0,0,26,12,8,5,10,35,61
Peru,Americas,2014,F,2,3,10,13,7,0,0,30,15,8,8,10,41,71
Philippines,Asia,2014,PF,3,3,9,10,7,0,0,26,14,8,5,10,37,63
Poland,Europe,2014,F,1,1,12,16,10,0,0,38,16,12,13,14,55,93
Portugal,Europe,2014,F,1,1,12,16,11,0,0,39,16,12,15,15,58,97
Puerto Rico,Americas,2014,F,1,2,12,15,10,0,0,37,16,10,12,14,52,89
Qatar,Middle East,2014,NF,6,5,2,2,3,0,3,10,8,2,4,4,18,28
Romania,Europe,2014,F,2,2,12,14,9,0,0,35,14,11,12,12,49,84
Russia,Eurasia,2014,NF,6,5,1,3,3,0,0,7,6,4,2,7,19,26
Rwanda,Africa,2014,NF,6,5,2,2,5,0,0,9,5,2,3,7,17,26
Samoa,Asia,2014,F,2,2,9,13,10,0,0,32,14,10,13,12,49,81
San Marino,Europe,2014,F,1,1,12,16,12,0,0,40,16,12,16,16,60,100
Sao Tome and Principe,Africa,2014,F,2,2,11,14,9,0,0,34,15,10,12,10,47,81
Saudi Arabia,Middle East,2014,NF,7,7,0,0,1,0,2,3,3,0,2,2,7,10
Senegal,Africa,2014,F,2,2,11,13,9,0,0,33,15,11,10,10,46,79
Serbia,Europe,2014,F,2,2,9,14,7,0,0,30,15,10,10,13,48,78
Seychelles,Africa,2014,PF,3,3,8,10,7,0,0,25,11,9,11,11,42,67
Sierra Leone,Africa,2014,PF,3,3,10,12,7,0,0,29,12,7,9,10,38,67
Singapore,Asia,2014,PF,4,4,4,8,7,0,0,19,9,4,7,12,32,51
Slovakia,Europe,2014,F,1,1,12,15,10,0,0,37,16,12,12,14,54,91
Slovenia,Europe,2014,F,1,1,12,15,11,0,0,38,14,12,14,13,53,91
Solomon Islands,Asia,2014,PF,4,3,6,10,6,0,0,22,14,9,8,12,43,65
Somalia,Africa,2014,NF,7,7,0,0,0,0,0,0,1,0,0,1,2,2
Somaliland,Africa,2014,PF,4,5,5,10,6,0,0,21,7,5,7,6,25,46
South Africa,Africa,2014,F,2,2,12,13,8,0,0,33,15,12,10,11,48,81
South Korea,Asia,2014,F,2,2,11,14,10,0,0,35,14,11,13,12,50,85
South Ossetia,Eurasia,2014,NF,7,6,0,0,0,3,0,-3,4,0,1,3,8,5
South Sudan,Africa,2014,NF,6,6,4,2,2,0,0,8,7,3,1,5,16,24
Spain,Europe,2014,F,1,1,12,16,11,0,0,39,15,12,15,15,57,96
Sri Lanka,Asia,2014,PF,5,4,6,6,4,0,0,16,7,6,5,8,26,42
St. Kitts and Nevis,Americas,2014,F,1,1,12,16,9,0,0,37,15,12,13,13,53,90
St. Lucia,Americas,2014,F,1,1,12,16,11,0,0,39,15,12,12,14,53,92
St. Vincent and the Grenadines,Americas,2014,F,1,1,11,16,9,0,0,36,15,12,12,14,53,89
Sudan,Africa,2014,NF,7,7,2,3,1,4,0,2,3,1,0,1,5,7
Suriname,Americas,2014,F,2,2,12,13,8,0,0,33,15,11,8,10,44,77
Sweden,Europe,2014,F,1,1,12,16,12,0,0,40,16,12,15,16,59,99
Switzerland,Europe,2014,F,1,1,12,15,12,0,0,39,15,12,15,15,57,96
Syria,Middle East,2014,NF,7,7,0,0,0,2,0,-2,1,0,0,2,3,1
Taiwan,Asia,2014,F,1,2,11,15,10,0,0,36,14,11,14,13,52,88
Tajikistan,Eurasia,2014,NF,6,6,2,4,2,0,0,8,5,4,3,4,16,24
Tanzania,Africa,2014,PF,3,3,9,12,8,0,0,29,10,7,9,9,35,64
Thailand,Asia,2014,PF,4,4,8,9,5,0,0,22,10,6,6,10,32,54
Gambia,Africa,2014,NF,6,6,2,5,0,0,0,7,4,3,1,6,14,21
Tibet,Asia,2014,NF,7,7,0,0,1,3,0,-2,0,0,0,3,3,1
Timor-Leste,Asia,2014,PF,3,4,11,12,6,0,0,29,12,7,6,9,34,63
Togo,Africa,2014,PF,4,4,5,8,5,0,0,18,9,6,7,7,29,47
Tonga,Asia,2014,F,2,2,11,14,6,0,0,31,13,8,11,12,44,75
Transnistria,Eurasia,2014,NF,6,6,3,5,2,0,0,10,5,2,2,5,14,24
Trinidad and Tobago,Americas,2014,F,2,2,11,13,9,0,0,33,15,11,9,13,48,81
Tunisia,Africa,2014,PF,3,3,9,12,6,0,0,27,11,9,6,10,36,63
Turkey,Europe,2014,PF,3,4,11,10,7,0,0,28,9,6,8,9,32,60
Turkmenistan,Eurasia,2014,NF,7,7,0,1,0,0,0,1,2,0,1,3,6,7
Tuvalu,Asia,2014,F,1,1,12,15,10,0,0,37,16,12,15,14,57,94
Uganda,Africa,2014,PF,6,4,3,5,3,0,0,11,10,4,5,7,26,37
Ukraine,Eurasia,2014,PF,4,3,8,8,4,0,0,20,9,8,7,11,35,55
United Arab Emirates,Middle East,2014,NF,6,6,1,2,2,0,3,8,4,2,3,4,13,21
United Kingdom,Europe,2014,F,1,1,12,16,12,0,0,40,15,12,15,15,57,97
United States,Americas,2014,F,1,1,11,16,10,0,0,37,15,11,14,15,55,92
Uruguay,Americas,2014,F,1,1,12,16,12,0,0,40,16,12,15,15,58,98
Uzbekistan,Eurasia,2014,NF,7,7,0,0,0,0,0,0,1,0,0,3,4,4
Vanuatu,Asia,2014,F,2,2,9,15,8,0,0,32,15,11,10,11,47,79
Venezuela,Americas,2014,PF,5,5,5,7,2,0,0,14,8,4,4,8,24,38
Vietnam,Asia,2014,NF,7,5,0,1,2,0,0,3,4,1,4,8,17,20
West Bank,Middle East,2014,NF,6,5,2,5,2,2,0,7,8,6,5,5,24,31
Western Sahara,Africa,2014,NF,7,7,0,0,0,2,0,-2,3,0,0,4,7,5
Yemen,Middle East,2014,NF,6,6,3,4,3,0,0,10,6,3,2,5,16,26
Zambia,Africa,2014,PF,3,4,8,10,7,0,0,25,11,7,8,8,34,59
Zimbabwe,Africa,2014,NF,5,6,3,6,3,0,0,12,6,3,2,5,16,28
Abkhazia,Eurasia,2013,PF,4,5,7,7,4,0,0,18,8,5,4,5,22,40
Afghanistan,Asia,2013,NF,6,6,3,6,2,0,0,11,6,5,2,3,16,27
Albania,Europe,2013,PF,3,3,8,10,6,0,0,24,13,8,9,9,39,63
Algeria,Africa,2013,NF,6,5,4,4,3,0,0,11,7,5,5,7,24,35
Andorra,Europe,2013,F,1,1,12,15,12,0,0,39,16,11,15,15,57,96
Angola,Africa,2013,NF,6,5,4,6,1,0,0,11,8,4,4,3,19,30
Antigua and Barbuda,Americas,2013,F,2,2,11,13,7,0,0,31,14,9,13,13,49,80
Argentina,Americas,2013,F,2,2,11,14,6,0,0,31,14,11,11,13,49,80
Armenia,Eurasia,2013,PF,5,4,5,5,3,0,0,13,8,6,6,9,29,42
Australia,Asia,2013,F,1,1,12,15,12,0,0,39,16,12,15,15,58,97
Austria,Europe,2013,F,1,1,12,15,11,0,0,38,16,12,15,15,58,96
Azerbaijan,Eurasia,2013,NF,6,5,1,3,2,0,0,6,4,2,4,7,17,23
Bahamas,Americas,2013,F,1,1,12,16,10,0,0,38,16,12,15,15,58,96
Bahrain,Middle East,2013,NF,6,6,3,2,3,2,0,6,3,2,1,6,12,18
Bangladesh,Asia,2013,PF,3,4,9,11,5,0,0,25,9,7,6,9,31,56
Barbados,Americas,2013,F,1,1,12,16,12,0,0,40,16,12,16,15,59,99
Belarus,Eurasia,2013,NF,7,6,0,3,1,0,0,4,3,1,1,5,10,14
Belgium,Europe,2013,F,1,1,12,16,12,0,0,40,15,12,15,15,57,97
Belize,Americas,2013,F,1,2,12,14,11,0,0,37,15,11,12,13,51,88
Benin,Africa,2013,F,2,2,8,16,8,0,0,32,15,12,13,10,50,82
Bhutan,Asia,2013,PF,4,5,8,8,7,1,0,22,8,3,5,8,24,46
Bolivia,Americas,2013,PF,3,3,11,11,7,0,0,29,14,10,7,9,40,69
Bosnia and Herzegovina,Europe,2013,PF,3,3,8,11,6,0,0,25,10,7,10,10,37,62
Botswana,Africa,2013,F,3,2,10,10,8,0,0,28,13,10,12,11,46,74
Brazil,Americas,2013,F,2,2,11,14,8,0,0,33,15,10,10,13,48,81
Brunei,Asia,2013,NF,6,5,0,3,3,0,1,7,6,3,6,8,23,30
Bulgaria,Europe,2013,F,2,2,11,15,8,0,0,34,14,11,11,11,47,81
Burkina Faso,Africa,2013,PF,5,3,5,8,4,0,0,17,13,8,7,8,36,53
Burundi,Africa,2013,PF,5,5,4,6,2,0,0,12,8,4,4,6,22,34
Cabo Verde,Africa,2013,F,1,1,12,15,10,0,0,37,15,11,14,13,53,90
Cambodia,Asia,2013,NF,6,5,3,3,3,0,0,9,9,3,2,6,20,29
Cameroon,Africa,2013,NF,6,6,2,3,2,0,0,7,7,3,2,4,16,23
Canada,Americas,2013,F,1,1,12,16,12,0,0,40,16,11,15,16,58,98
Central African Republic,Africa,2013,PF,5,5,7,7,2,0,0,16,8,4,3,4,19,35
Chad,Africa,2013,NF,7,6,3,1,1,0,0,5,7,4,2,3,16,21
Chile,Americas,2013,F,1,1,12,15,12,0,0,39,16,11,15,15,57,96
China,Asia,2013,NF,7,6,0,1,2,1,0,2,4,3,2,6,15,17
Colombia,Americas,2013,PF,3,4,10,10,7,0,0,27,12,5,7,10,34,61
Comoros,Africa,2013,PF,3,4,9,11,5,0,0,25,10,6,8,6,30,55
Congo (Brazzaville),Africa,2013,NF,6,5,1,3,3,0,0,7,8,6,2,6,22,29
Congo (Kinshasa),Africa,2013,NF,6,6,3,4,2,0,0,9,7,3,0,1,11,20
Costa Rica,Americas,2013,F,1,1,12,15,11,0,0,38,16,11,13,13,53,91
Cote d'Ivoire,Africa,2013,PF,5,5,5,4,4,0,0,13,8,5,4,4,21,34
Croatia,Europe,2013,F,1,2,12,15,9,0,0,36,14,12,11,13,50,86
Cuba,Americas,2013,NF,7,6,0,0,1,0,0,1,2,0,2,6,10,11
Cyprus,Europe,2013,F,1,1,11,16,11,0,0,38,15,11,15,14,55,93
Czech Republic,Europe,2013,F,1,1,12,15,11,0,0,38,16,12,14,15,57,95
Denmark,Europe,2013,F,1,1,12,16,12,0,0,40,16,12,15,15,58,98
Djibouti,Africa,2013,NF,6,5,3,3,3,0,0,9,7,3,4,6,20,29
Dominica,Americas,2013,F,1,1,12,16,10,0,0,38,15,12,15,15,57,95
Dominican Republic,Americas,2013,F,2,2,10,12,9,0,0,31,15,10,8,11,44,75
Ecuador,Americas,2013,PF,3,3,7,11,6,0,0,24,13,7,6,10,36,60
Egypt,Africa,2013,PF,5,5,3,10,3,0,0,16,8,5,4,8,25,41
El Salvador,Americas,2013,F,2,3,12,14,9,0,0,35,15,8,9,10,42,77
Equatorial Guinea,Africa,2013,NF,7,7,0,1,0,0,0,1,4,0,0,3,7,8
Eritrea,Africa,2013,NF,7,7,0,0,1,0,0,1,0,0,0,2,2,3
Estonia,Europe,2013,F,1,1,12,15,12,0,0,39,16,12,14,14,56,95
Eswatini,Africa,2013,NF,7,5,0,1,0,0,0,1,8,3,5,4,20,21
Ethiopia,Africa,2013,NF,6,6,1,2,4,0,0,7,3,0,3,5,11,18
Fiji,Asia,2013,PF,6,4,0,5,2,0,0,7,11,3,6,10,30,37
Finland,Europe,2013,F,1,1,12,16,12,0,0,40,16,12,16,16,60,100
France,Europe,2013,F,1,1,12,15,11,0,0,38,15,12,15,15,57,95
Gabon,Africa,2013,NF,6,5,2,4,3,0,0,9,10,4,6,5,25,34
Gaza Strip,Middle East,2013,NF,6,6,5,2,2,0,0,9,4,3,0,3,10,19
Georgia,Eurasia,2013,PF,3,3,7,10,7,0,0,24,12,7,7,10,36,60
Germany,Europe,2013,F,1,1,12,15,12,0,0,39,15,12,15,15,57,96
Ghana,Africa,2013,F,1,2,12,15,10,0,0,37,14,11,12,10,47,84
Greece,Europe,2013,F,2,2,12,15,8,0,0,35,14,11,10,13,48,83
Grenada,Americas,2013,F,1,2,12,16,10,0,0,38,15,11,12,13,51,89
Guatemala,Americas,2013,PF,3,4,9,10,5,0,0,24,12,7,6,8,33,57
Guinea,Africa,2013,PF,5,5,5,8,2,0,0,15,9,6,4,5,24,39
Guinea-Bissau,Africa,2013,NF,6,5,2,5,0,0,0,7,10,5,3,5,23,30
Guyana,Americas,2013,F,2,3,11,13,7,0,0,31,15,9,7,9,40,71
Haiti,Americas,2013,PF,4,5,5,9,5,0,0,19,10,5,4,5,24,43
Honduras,Americas,2013,PF,4,4,6,8,4,0,0,18,11,6,7,9,33,51
Hong Kong,Asia,2013,PF,5,2,3,7,6,0,0,16,14,9,15,13,51,67
Hungary,Europe,2013,F,1,2,12,15,9,0,0,36,15,12,11,14,52,88
Iceland,Europe,2013,F,1,1,12,16,12,0,0,40,16,12,16,16,60,100
India,Asia,2013,F,2,3,11,14,9,0,0,34,13,11,8,10,42,76
Indian Kashmir,Asia,2013,PF,4,4,8,8,4,0,0,20,9,6,6,8,29,49
Indonesia,Asia,2013,F,2,3,11,13,6,0,0,30,12,9,5,9,35,65
Iran,Middle East,2013,NF,6,6,2,2,2,0,0,6,2,1,3,4,10,16
Iraq,Middle East,2013,NF,6,6,7,4,1,1,0,11,5,4,0,4,13,24
Ireland,Europe,2013,F,1,1,12,16,11,0,0,39,16,12,15,15,58,97
Israel,Middle East,2013,F,1,2,12,14,10,0,0,36,12,11,11,11,45,81
Italy,Europe,2013,F,2,1,11,15,9,0,0,35,15,12,12,14,53,88
Jamaica,Americas,2013,F,2,3,12,13,8,0,0,33,15,9,6,10,40,73
Japan,Asia,2013,F,1,2,12,15,10,0,0,37,13,10,15,13,51,88
Jordan,Middle East,2013,NF,6,5,2,5,3,0,0,10,7,3,6,8,24,34
Kazakhstan,Eurasia,2013,NF,6,5,2,3,1,0,0,6,5,3,4,8,20,26
Kenya,Africa,2013,PF,4,4,6,10,5,0,0,21,13,8,6,7,34,55
Kiribati,Asia,2013,F,1,1,12,16,8,0,0,36,15,12,15,13,55,91
Kosovo,Europe,2013,PF,5,4,6,8,3,1,0,16,8,6,5,7,26,42
Kuwait,Middle East,2013,PF,5,5,2,10,5,0,0,17,7,4,7,6,24,41
Kyrgyzstan,Eurasia,2013,PF,5,5,6,6,4,2,0,14,9,5,4,7,25,39
Laos,Asia,2013,NF,7,6,0,0,0,0,0,0,4,0,2,5,11,11
Latvia,Europe,2013,F,2,2,12,14,7,0,0,33,15,12,12,12,51,84
Lebanon,Middle East,2013,PF,5,4,5,9,3,0,0,17,11,7,5,9,32,49
Lesotho,Africa,2013,F,2,3,10,13,8,0,0,31,14,7,11,9,41,72
Liberia,Africa,2013,PF,3,4,9,11,6,0,0,26,11,8,7,8,34,60
Libya,Africa,2013,PF,4,5,9,10,3,0,0,22,8,6,1,6,21,43
Liechtenstein,Europe,2013,F,1,1,12,15,12,0,0,39,16,12,15,16,59,98
Lithuania,Europe,2013,F,1,1,12,16,9,0,0,37,16,11,13,13,53,90
Luxembourg,Europe,2013,F,1,1,12,16,12,0,0,40,16,12,16,16,60,100
Madagascar,Africa,2013,PF,6,4,1,5,1,0,0,7,9,7,5,7,28,35
Malawi,Africa,2013,PF,3,4,8,11,7,0,0,26,11,7,9,7,34,60
Malaysia,Asia,2013,PF,4,4,6,8,6,0,0,20,9,5,5,9,28,48
Maldives,Asia,2013,PF,5,4,7,6,4,0,0,17,7,7,7,8,29,46
Mali,Africa,2013,NF,7,5,1,3,2,1,0,5,8,4,3,4,19,24
Malta,Europe,2013,F,1,1,12,16,11,0,0,39,16,12,15,15,58,97
Marshall Islands,Asia,2013,F,1,1,11,15,10,0,0,36,16,11,15,13,55,91
Mauritania,Africa,2013,NF,6,5,3,3,5,0,0,11,10,4,4,5,23,34
Mauritius,Africa,2013,F,1,2,12,15,11,0,0,38,15,12,13,12,52,90
Mexico,Americas,2013,PF,3,3,9,12,7,0,0,28,13,8,6,10,37,65
Micronesia,Asia,2013,F,1,1,12,15,10,0,0,37,16,11,15,14,56,93
Moldova,Eurasia,2013,PF,3,3,11,12,6,0,0,29,11,8,8,9,36,65
Monaco,Europe,2013,F,2,1,10,11,10,0,0,31,15,12,15,14,56,87
Mongolia,Asia,2013,F,1,2,11,16,9,0,0,36,15,11,12,12,50,86
Montenegro,Europe,2013,F,3,2,9,11,7,0,0,27,13,10,10,12,45,72
Morocco,Africa,2013,PF,5,4,5,7,4,0,0,16,8,6,6,7,27,43
Mozambique,Africa,2013,PF,4,3,6,10,7,0,0,23,12,7,8,9,36,59
Myanmar,Asia,2013,NF,6,5,3,6,3,3,0,9,7,4,1,5,17,26
Nagorno-Karabakh,Eurasia,2013,PF,5,5,4,5,3,0,0,12,6,3,5,5,19,31
Namibia,Africa,2013,F,2,2,10,11,9,0,0,30,14,12,11,9,46,76
Nauru,Asia,2013,F,1,1,12,16,10,0,0,38,15,11,15,14,55,93
Nepal,Asia,2013,PF,4,4,5,11,4,0,0,20,9,6,5,7,27,47
Netherlands,Europe,2013,F,1,1,12,16,12,0,0,40,16,12,15,16,59,99
New Zealand,Asia,2013,F,1,1,12,15,12,0,0,39,16,12,15,15,58,97
Nicaragua,Americas,2013,PF,5,4,6,7,4,0,0,17,12,6,7,9,34,51
Niger,Africa,2013,PF,3,4,9,10,7,0,0,26,11,8,5,6,30,56
Nigeria,Africa,2013,PF,4,4,6,9,5,0,0,20,9,7,4,6,26,46
North Korea,Asia,2013,NF,7,7,0,0,0,0,0,0,0,0,0,3,3,3
North Macedonia,Europe,2013,PF,3,3,8,11,7,0,0,26,11,8,8,11,38,64
Northern Cyprus,Europe,2013,F,2,2,11,12,9,0,0,32,13,9,12,12,46,78
Norway,Europe,2013,F,1,1,12,16,12,0,0,40,16,12,16,16,60,100
Oman,Middle East,2013,NF,6,5,2,2,2,0,3,9,5,3,4,5,17,26
Pakistan,Asia,2013,PF,4,5,6,9,5,0,0,20,5,7,4,6,22,42
Pakistani Kashmir,Asia,2013,NF,6,5,3,4,3,2,0,8,6,5,4,6,21,29
Palau,Asia,2013,F,1,1,12,15,10,0,0,37,16,11,15,13,55,92
Panama,Americas,2013,F,1,2,12,15,9,0,0,36,15,10,9,12,46,82
Papua New Guinea,Asia,2013,PF,4,3,9,10,4,0,0,23,12,9,7,8,36,59
Paraguay,Americas,2013,PF,3,3,10,12,5,0,0,27,11,8,6,10,35,62
Peru,Americas,2013,F,2,3,10,13,7,0,0,30,15,8,8,10,41,71
Philippines,Asia,2013,PF,3,3,9,10,7,0,0,26,14,8,5,10,37,63
Poland,Europe,2013,F,1,1,12,16,10,0,0,38,16,12,13,14,55,93
Portugal,Europe,2013,F,1,1,12,16,11,0,0,39,16,12,15,15,58,97
Puerto Rico,Americas,2013,F,1,2,12,15,10,0,0,37,16,10,12,14,52,89
Qatar,Middle East,2013,NF,6,5,2,2,3,0,3,10,8,2,4,4,18,28
Romania,Europe,2013,F,2,2,10,14,8,0,0,32,14,11,12,12,49,81
Russia,Eurasia,2013,NF,6,5,1,3,3,0,0,7,6,4,3,7,20,27
Rwanda,Africa,2013,NF,6,6,2,2,4,0,0,8,4,2,3,7,16,24
Samoa,Asia,2013,F,2,2,9,13,10,0,0,32,14,10,13,12,49,81
San Marino,Europe,2013,F,1,1,12,16,12,0,0,40,16,12,16,16,60,100
Sao Tome and Principe,Africa,2013,F,2,2,11,14,9,0,0,34,15,10,12,10,47,81
Saudi Arabia,Middle East,2013,NF,7,7,0,0,1,0,2,3,3,0,2,2,7,10
Senegal,Africa,2013,F,2,3,11,13,8,0,0,32,14,10,10,9,43,75
Serbia,Europe,2013,F,2,2,9,14,7,0,0,30,15,10,10,13,48,78
Seychelles,Africa,2013,PF,3,3,8,10,7,0,0,25,11,9,11,11,42,67
Sierra Leone,Africa,2013,F,2,3,10,12,8,0,0,30,13,8,9,10,40,70
Singapore,Asia,2013,PF,4,4,4,8,7,0,0,19,10,4,7,12,33,52
Slovakia,Europe,2013,F,1,1,12,15,10,0,0,37,16,12,13,14,55,92
Slovenia,Europe,2013,F,1,1,12,15,11,0,0,38,14,12,14,13,53,91
Solomon Islands,Asia,2013,PF,4,3,6,10,6,0,0,22,14,9,8,12,43,65
Somalia,Africa,2013,NF,7,7,0,0,0,0,0,0,1,0,0,1,2,2
Somaliland,Africa,2013,PF,4,5,5,10,6,0,0,21,7,5,7,6,25,46
South Africa,Africa,2013,F,2,2,12,14,8,0,0,34,15,11,10,11,47,81
South Korea,Asia,2013,F,1,2,11,15,10,0,0,36,14,11,13,12,50,86
South Ossetia,Eurasia,2013,NF,7,6,0,0,0,3,0,-3,4,0,1,3,8,5
South Sudan,Africa,2013,NF,6,5,4,5,2,0,0,11,8,4,3,5,20,31
Spain,Europe,2013,F,1,1,12,16,11,0,0,39,16,12,14,15,57,96
Sri Lanka,Asia,2013,PF,5,4,6,6,4,0,0,16,8,6,5,8,27,43
St. Kitts and Nevis,Americas,2013,F,1,1,12,16,10,0,0,38,15,12,12,14,53,91
St. Lucia,Americas,2013,F,1,1,12,16,11,0,0,39,16,12,12,14,54,93
St. Vincent and the Grenadines,Americas,2013,F,1,1,11,16,9,0,0,36,15,11,13,14,53,89
Sudan,Africa,2013,NF,7,7,2,3,1,4,0,2,3,1,0,1,5,7
Suriname,Americas,2013,F,2,2,12,13,8,0,0,33,15,11,8,10,44,77
Sweden,Europe,2013,F,1,1,12,16,12,0,0,40,16,12,16,16,60,100
Switzerland,Europe,2013,F,1,1,12,15,12,0,0,39,15,12,15,15,57,96
Syria,Middle East,2013,NF,7,7,0,0,1,2,0,-1,2,0,0,4,6,5
Taiwan,Asia,2013,F,1,2,11,15,10,0,0,36,14,11,14,13,52,88
Tajikistan,Eurasia,2013,NF,6,6,2,4,2,0,0,8,5,4,3,4,16,24
Tanzania,Africa,2013,PF,3,3,9,12,7,0,0,28,11,7,11,9,38,66
Thailand,Asia,2013,PF,4,4,8,9,5,0,0,22,9,6,6,10,31,53
Gambia,Africa,2013,NF,6,6,2,5,0,0,0,7,5,4,1,6,16,23
Tibet,Asia,2013,NF,7,7,0,0,1,3,0,-2,0,0,0,3,3,1
Timor-Leste,Asia,2013,PF,3,4,11,12,6,0,0,29,12,7,6,9,34,63
Togo,Africa,2013,PF,5,4,4,8,4,0,0,16,8,6,6,7,27,43
Tonga,Asia,2013,F,3,2,11,14,4,0,0,29,13,8,11,12,44,73
Transnistria,Eurasia,2013,NF,6,6,3,5,2,0,0,10,6,2,2,5,15,25
Trinidad and Tobago,Americas,2013,F,2,2,11,13,9,0,0,33,15,11,9,13,48,81
Tunisia,Africa,2013,PF,3,4,9,12,5,0,0,26,10,8,6,9,33,59
Turkey,Europe,2013,PF,3,4,11,10,7,0,0,28,9,7,7,10,33,61
Turkmenistan,Eurasia,2013,NF,7,7,0,1,0,0,0,1,2,0,1,3,6,7
Tuvalu,Asia,2013,F,1,1,12,15,10,0,0,37,16,12,15,14,57,94
Uganda,Africa,2013,PF,5,4,3,6,3,0,0,12,11,4,6,7,28,40
Ukraine,Eurasia,2013,PF,4,3,8,9,4,0,0,21,10,8,7,11,36,57
United Arab Emirates,Middle East,2013,NF,6,6,1,2,2,0,3,8,4,2,4,4,14,22
United Kingdom,Europe,2013,F,1,1,12,16,12,0,0,40,15,12,15,15,57,97
United States,Americas,2013,F,1,1,11,16,10,0,0,37,16,11,14,15,56,93
Uruguay,Americas,2013,F,1,1,12,16,11,0,0,39,16,12,15,15,58,97
Uzbekistan,Eurasia,2013,NF,7,7,0,0,0,0,0,0,1,0,0,3,4,4
Vanuatu,Asia,2013,F,2,2,9,15,8,0,0,32,15,11,10,11,47,79
Venezuela,Americas,2013,PF,5,5,5,8,2,0,0,15,9,4,4,7,24,39
Vietnam,Asia,2013,NF,7,5,0,1,1,0,0,2,4,1,4,8,17,19
West Bank,Middle East,2013,NF,6,5,2,5,2,3,0,6,8,6,5,5,24,30
Western Sahara,Africa,2013,NF,7,7,0,0,0,2,0,-2,3,0,0,4,7,5
Yemen,Middle East,2013,NF,6,6,3,4,2,0,0,9,6,3,2,5,16,25
Zambia,Africa,2013,PF,3,4,9,12,7,0,0,28,11,7,8,8,34,62
Zimbabwe,Africa,2013,NF,6,6,3,5,3,0,0,11,6,3,1,4,14,25
